R    1920 1080
NO      ./wood.xpm
SO    ./colorstone.xpm
WE    ./redbrick.xpm
EA    ./greystone.xpm
S ./barrel.xpm
F 230,   180, 13
C 51, 247, 251
    1111111111111
 11100000111001
100020000000001
100000200000111
10010000N001
100000000001
111101111111
   111




